1 1 1 1 1 1 1 1 1 1 1 1 1 1 1 1
1 3 3 3 6 5 4 8 7 12 3 3 3 3 10 1
1 0 0 0 0 0 0 0 0 0 0 0 0 0 0 1
1 0 0 0 0 0 0 0 0 0 0 0 0 0 0 1
11 0 0 13 3 3 3 3 3 3 3 3 9 3 3 11
1 0 0 0 0 0 0 0 0 0 0 0 0 0 0 1
1 0 0 0 0 0 0 0 0 0 0 0 0 0 0 1
1 0 0 0 0 0 0 0 0 0 0 0 0 0 0 1
11 0 0 0 15 0 0 0 0 0 0 0 0 0 0 11
1 0 0 0 0 0 0 0 0 0 0 0 0 0 0 1
1 0 0 0 0 0 0 0 0 0 0 0 0 0 0 1
1 1 1 1 1 1 14 1 2 1 1 1 1 1 1 1
